WWWWWWW
WS    W
WWWWW W
W   W W
WFW   W
WWWWWWW
