WWWWW
WS  W
WWW W
WFW W
W   W
WWWWW
